auto		automatic	自动
btn		button		按钮
cmd		command		命令
cur		current		当前（与pre,next,tag联合使用)
def		define		定义（一般是常量)
desc/dsc	description	描述		
dup		duplicate copy	副本
dest		destination	目的地
errCode	        error code      错误码	
impl		implementation	实现
info		infomation	信息，数据
min		minimum		最小
max		maximum		最大
mgr		manager		管理器
msg		message         消息
num		number		数字
nav		navigation	定位，导航
pic		picture		图片
pre		previous	先前的，上一个(pre本身也是前缀)
pos		position	位置
regexp		regular expression	正则表达式
sim		simulate	模拟
tag		target		目标
util		utility		实用（方便函数）
vo		value object	值对象（数据对象，有时我们会命名为XX info）


str = strength 		力量
dex = dexterity 	敏捷
int = intelligence	智力
con = constitution 	体质
wis = wisdom 		智慧
cha/chr = charisma 	魅力

AG = alignment 	阵营

CLR/CLC/MS 	cleric 		牧师
FTR 		FIGHTER		战士
BARB BBN 	barbarian	野蛮人	 
sor 		sorcerer	术士
wiz 		wizard 		法师
bard 		一般没有缩写	诗人
monk 		武僧		顶多缩成mnk 
pal/pally 	paladin 	圣武士
rog/dz 		rogue		盗贼
rgr 		ranger 		巡林客
dru 		druid 		德鲁伊
wm 		weapon master 	武器大师
sdd 		shadow dancer 	影舞者
dwd 		dwarven defender 矮人防御者
sft 		shifter 	变形大师




  
